Prefix	Species name
ENSMPU	Mustela putorius furo (Ferret)
ENSACC	Aquila chrysaetos chrysaetos (Golden eagle)
ENSACO	Amazona collaria (Yellow-billed parrot)
ENSCWA	Catagonus wagneri (Chacoan peccary)
ENSIPU	Ictalurus punctatus (Channel catfish)
ENSMMS	Moschus moschiferus (Siberian musk deer)
ENSONI	Oreochromis niloticus (Nile tilapia)
ENSJJA	Jaculus jaculus (Lesser Egyptian jerboa)
ENSBIX	Bos indicus x Bos taurus (Hybrid - Bos Indicus)
ENSCDR	Camelus dromedarius (Arabian camel)
ENSOME	Oryzias melastigma (Indian medaka)
ENSSSC	Sus scrofa (Pig - Landrace)
ENSANA	Aotus nancymaae (Ma's night monkey)
ENSORL	Oryzias latipes (Japanese medaka HdrR)
ENSCJA	Callithrix jacchus (Marmoset)
ENSSSC	Sus scrofa (Pig - Wuzhishan)
ENSMOD	Monodelphis domestica (Opossum)
ENSCAF	Canis lupus familiaris (Dog - Great Dane)
ENSRNO	Rattus norvegicus (Rat)
ENSPST	Pavo cristatus (Indian peafowl)
ENS	Homo sapiens (Human)
ENSARW	Apteryx rowi (Okarito brown kiwi)
ENSMLU	Myotis lucifugus (Microbat)
ENSCAF	Canis lupus familiaris (Dog)
ENSCHO	Choloepus hoffmanni (Sloth)
ENSEAS	Equus asinus asinus (Donkey)
ENSSSA	Salmo salar (Atlantic salmon)
ENSPSI	Pelodiscus sinensis (Chinese softshell turtle)
ENSGMO	Gadus morhua (Cod)
ENSRFE	Rhinolophus ferrumequinum (Greater horseshoe bat)
MGP_AKRJ_	Mus musculus (Mouse AKR/J)
ENSTGU	Taeniopygia guttata (Zebra finch)
ENSCPO	Cavia porcellus (Guinea Pig)
ENSBGR	Bos grunniens (Domestic yak)
ENSCPU	Calidris pugnax (Ruff)
MGP_SPRETEiJ_	Mus spretus (Algerian mouse)
ENSGGO	Gorilla gorilla gorilla (Gorilla)
ENSPCA	Procavia capensis (Hyrax)
ENSMNE	Macaca nemestrina (Pig-tailed macaque)
ENSMUS	Mus musculus (Mouse)
ENSSSC	Sus scrofa (Pig - Jinhua)
ENSCPR	Crocodylus porosus (Australian saltwater crocodile)
ENSPNA	Pygocentrus nattereri (Red-bellied piranha)
ENSSSC	Sus scrofa (Pig - Largewhite)
ENSMAM	Mastacembelus armatus (Zig-zag eel)
ENSCHA	Scleropages formosus (Asian bonytongue)
ENSNME	Numida meleagris (Helmeted guineafowl)
ENSVUR	Vombatus ursinus (Common wombat)
ENSTBE	Tupaia belangeri (Tree Shrew)
ENSPMG	Periophthalmus magnuspinnatus (Periophthalmus magnuspinnatus)
ENSCHI	Capra hircus (Goat)
ENSPRN	Parambassis ranga (Indian glassy fish)
ENSORL	Oryzias latipes (Japanese medaka HSOK)
ENSGWI	Gouania willdenowi (Blunt-snouted clingfish)
ENSCAN	Colobus angolensis palliatus (Angola colobus)
ENSMMD	Myripristis murdjan (Pinecone soldierfish)
ENSMGA	Meleagris gallopavo (Turkey)
ENSBMU	Bos mutus (Wild yak)
ENSBSL	Betta splendens (Siamese fighting fish)
ENSPTX	Pseudonaja textilis (Eastern brown snake)
ENSMUN	Melopsittacus undulatus (Budgerigar)
ENSNLE	Nomascus leucogenys (Gibbon)
ENSMVI	Manacus vitellinus (Golden-collared manakin)
ENSSMR	Salvator merianae (Argentine black and white tegu)
MGP_DBA2J_	Mus musculus (Mouse DBA/2J)
ENSANI	Accipiter nisus (Eurasian sparrowhawk)
ENSNML	Neogobius melanostomus (Round goby)
ENSAME	Ailuropoda melanoleuca (Panda)
MGP_129S1SvImJ_	Mus musculus (Mouse 129S1/SvImJ)
ENSSSC	Sus scrofa (Pig USMARC)
ENSPVA	Pteropus vampyrus (Megabat)
ENSSSC	Sus scrofa (Pig - Tibetan)
ENSMOC	Microtus ochrogaster (Prairie vole)
ENSJHY	Junco hyemalis (Dark-eyed junco)
ENSFCA	Felis catus (Cat)
MGP_AJ_	Mus musculus (Mouse A/J)
ENSPTI	Panthera tigris altaica (Tiger)
ENSCPG	Calidris pygmaea (Spoon-billed sandpiper)
ENSCSAV	Ciona savignyi
ENSPMJ	Parus major (Great Tit)
ENSSAR	Sorex araneus (Shrew)
ENSPSM	Prolemur simus (Greater bamboo lemur)
ENSSLD	Seriola lalandi dorsalis (Yellowtail amberjack)
MGP_CASTEiJ_	Mus musculus castaneus (Mouse CAST/EiJ)
ENSGAG	Gopherus agassizii (Agassiz's desert tortoise)
ENSMLE	Mandrillus leucophaeus (Drill)
MGP_C57BL6NJ_	Mus musculus (Mouse C57BL/6NJ)
ENSODE	Octodon degus (Degu)
ENSLAC	Latimeria chalumnae (Coelacanth)
ENSSDA	Spermophilus dauricus (Daurian ground squirrel)
ENSABR	Anser brachyrhynchus (Pink-footed goose)
MGP_NZOHlLtJ_	Mus musculus (Mouse NZO/HlLtJ)
ENSEBU	Eptatretus burgeri (Hagfish)
ENSPCT	Physeter catodon (Sperm whale)
ENSCJP	Coturnix japonica (Japanese quail)
ENSAOW	Apteryx owenii (Little spotted kiwi)
ENSRBI	Rhinopithecus bieti (Black snub-nosed monkey)
ENSNPE	Nothoprocta perdicaria (Chilean tinamou)
ENSSSC	Sus scrofa (Pig - Meishan)
ENSSHA	Sarcophilus harrisii (Tasmanian devil)
ENSHGLM	Heterocephalus glaber (Naked mole-rat male)
ENSAPO	Acanthochromis polyacanthus (Spiny chromis)
ENSTGE	Theropithecus gelada (Gelada)
ENSAHA	Apteryx haastii (Great spotted kiwi)
ENSPNY	Pundamilia nyererei (Makobe Island cichlid)
ENSPVI	Pogona vitticeps (Central bearded dragon)
ENSSSU	Suricata suricatta (Meerkat)
ENSPCO	Propithecus coquereli (Coquerel's sifaka)
ENSPPA	Pan paniscus (Bonobo)
ENSHCO	Hippocampus comes (Tiger tail seahorse)
ENSSCA	Serinus canaria (Common canary)
ENSGAL	Gallus gallus (Chicken)
ENSPFO	Poecilia formosa (Amazon molly)
ENSACD	Anser cygnoides (Swan goose)
ENSCSE	Cynoglossus semilaevis (Tongue sole)
ENSNVI	Neovison vison (American mink)
ENSSSC	Sus scrofa (Pig - Rongchang)
ENSORL	Oryzias latipes (Japanese medaka HNI)
ENSSPA	Stegastes partitus (Bicolor damselfish)
ENSOAB	Oreochromis aureus (Blue tilapia)
ENSSMA	Scophthalmus maximus (Turbot)
ENSPPR	Panthera pardus (Leopard)
ENSSHB	Strigops habroptila (Kakapo)
ENSFAL	Ficedula albicollis (Flycatcher)
ENSNBR	Neolamprologus brichardi (Lyretail cichlid)
ENSLCO	Lepidothrix coronata (Blue-crowned manakin)
ENSCCA	Cebus capucinus imitator (Capuchin)
ENSUAM	Ursus americanus (American black bear)
ENSECA	Equus caballus (Horse)
MGP_WSBEiJ_	Mus musculus domesticus (Mouse WSB/EiJ)
ENSMAL	Monopterus albus (Swamp eel)
ENSCSA	Chlorocebus sabaeus (Vervet-AGM)
ENSSBO	Saimiri boliviensis boliviensis (Bolivian squirrel monkey)
ENSATE	Anabas testudineus (Climbing perch)
ENSMUG	Meriones unguiculatus (Mongolian gerbil)
ENSDNV	Dromaius novaehollandiae (Emu)
ENSVVU	Vulpes vulpes (Red fox)
ENSSSC	Sus scrofa (Pig - Pietrain)
ENSPKI	Paramormyrops kingsleyae (Paramormyrops kingsleyae)
ENSSTU	Salmo trutta (River trout)
ENSOCU	Oryctolagus cuniculus (Rabbit)
ENSACU	Athene cunicularia (Burrowing owl)
ENSPMA	Petromyzon marinus (Lamprey)
ENSAOC	Amphiprion ocellaris (Clown anemonefish)
ENSMMM	Marmota marmota marmota (Alpine marmot)
ENSDAR	Danio rerio (Zebrafish)
ENSCGO	Cottoperca gobio (Channel bull blenny)
ENSCCN	Castor canadensis (American beaver)
ENSENL	Echeneis naucrates (Live sharksucker)
ENSTRU	Takifugu rubripes (Fugu)
ENSDOR	Dipodomys ordii (Kangaroo rat)
ENSFHE	Fundulus heteroclitus (Mummichog)
ENSMSI	Mus spicilegus (Steppe mouse)
ENSSSC	Sus scrofa (Pig - Hampshire)
ENSCGR	Cricetulus griseus (Chinese hamster CHOK1GS)
ENSDCD	Denticeps clupeoides (Denticle herring)
ENSPCL	Phasianus colchicus (Ring-necked pheasant)
ENSTTR	Tursiops truncatus (Dolphin)
ENSCVA	Cyprinodon variegatus (Sheepshead minnow)
ENSPPY	Pongo abelii (Orangutan)
MGP_NODShiLtJ_	Mus musculus (Mouse NOD/ShiLtJ)
ENSEEE	Electrophorus electricus (Electric eel)
ENSLAF	Loxodonta africana (Elephant)
MGP_PahariEiJ_	Mus pahari (Shrew mouse)
ENSTSY	Carlito syrichta (Tarsier)
ENSCGR	Cricetulus griseus (Chinese hamster PICR)
ENSVPA	Vicugna pacos (Alpaca)
ENSBBB	Bison bison bison (American bison)
ENSAPL	Anas platyrhynchos platyrhynchos (Duck)
ENSNGA	Nannospalax galili (Upper Galilee mountains blind mole rat)
ENSZAL	Zonotrichia albicollis (White-throated sparrow)
ENSSTO	Ictidomys tridecemlineatus (Squirrel)
MGP_CAROLIEiJ_	Mus caroli (Ryukyu mouse)
ENSXCO	Xiphophorus couchianus (Monterrey platyfish)
ENSHBU	Haplochromis burtoni (Burton's mouthbrooder)
ENSPAN	Papio anubis (Olive baboon)
MGP_LPJ_	Mus musculus (Mouse LP/J)
ENSMAU	Mesocricetus auratus (Golden Hamster)
ENSSFA	Salarias fasciatus (Jewelled blenny)
ENSUMA	Ursus maritimus (Polar bear)
ENSOAN	Ornithorhynchus anatinus (Platypus)
ENSSPU	Sphenodon punctatus (Tuatara)
ENSACL	Astatotilapia calliptera (Eastern happy)
ENSAMX	Astyanax mexicanus (Pachon cavefish)
ENSCCR	Cyprinus carpio (Common carp german mirror)
ENSPMR	Podarcis muralis (Common wall lizard)
ENSSSC	Sus scrofa (Pig - Berkshire)
ENSKMA	Kryptolebias marmoratus (Mangrove rivulus)
ENSBIX	Bos indicus x Bos taurus (Hybrid - Bos Taurus)
ENSLCR	Larimichthys crocea (Large yellow croaker)
ENSCAT	Cercocebus atys (Sooty mangabey)
ENSCCR	Cyprinus carpio (Common carp hebao red)
ENSNSU	Notechis scutatus (Mainland tiger snake)
ENSSDU	Seriola dumerili (Greater amberjack)
ENSCGR	Cricetulus griseus (Chinese hamster CriGri)
ENSACI	Amphilophus citrinellus (Midas cichlid)
ENSMEU	Notamacropus eugenii (Wallaby)
ENSXET	Xenopus tropicalis (Tropical clawed frog)
ENSMZE	Maylandia zebra (Zebra mbuna)
ENSFDA	Fukomys damarensis (Damara mole rat)
ENSXMA	Xiphophorus maculatus (Platyfish)
ENSDNO	Dasypus novemcinctus (Armadillo)
ENSTNI	Tetraodon nigroviridis (Tetraodon)
ENSOAR	Ovis aries (Sheep)
ENSCAP	Cavia aperea (Brazilian guinea pig)
ENSCEL	Caenorhabditis elegans (Caenorhabditis elegans)
MGP_BALBcJ_	Mus musculus (Mouse BALB/cJ)
ENSCCE	Cyanistes caeruleus (Blue tit)
ENSSRH	Sinocyclocheilus rhinocerous (Horned golden-line barbel)
ENSMMO	Mola mola (Ocean sunfish)
MGP_PWKPhJ_	Mus musculus musculus (Mouse PWK/PhJ)
ENSPTR	Pan troglodytes (Chimpanzee)
ENSETE	Echinops telfairi (Lesser hedgehog tenrec)
ENSELU	Esox lucius (Northern pike)
ENSBTA	Bos taurus (Cow)
ENSMMU	Macaca mulatta (Macaque)
ENSGAC	Gasterosteus aculeatus (Stickleback)
ENSEEU	Erinaceus europaeus (Hedgehog)
ENSLOC	Lepisosteus oculatus (Spotted gar)
ENSPME	Poecilia mexicana (Shortfin molly)
ENSCAF	Canis lupus familiaris (Dog - Basenji)
ENSSOR	Sphaeramia orbicularis (Orbiculate cardinalfish)
ENSLCN	Lynx canadensis (Canada lynx)
ENSCAB	Chelonoidis abingdonii (Abingdon island giant tortoise)
ENSHHU	Hucho hucho (Huchen)
ENSSSC	Sus scrofa (Pig)
ENSSAU	Sparus aurata (Gilthead seabream)
ENSAPE	Amphiprion percula (Orange clownfish)
ENSUPA	Urocitellus parryii (Arctic ground squirrel)
ENSPTE	Piliocolobus tephrosceles (Ugandan red Colobus)
ENSECR	Erpetoichthys calabaricus (Reedfish)
ENSCPI	Chrysolophus pictus (Golden pheasant)
ENSGAF	Gambusia affinis (Western mosquitofish)
ENSACA	Anolis carolinensis (Anole lizard)
ENSVKK	Varanus komodoensis (Komodo dragon)
ENSSAN	Sinocyclocheilus anshuiensis (Blind barbel)
ENSLCA	Lates calcarifer (Barramundi perch)
ENSAMX	Astyanax mexicanus (Mexican tetra)
ENSEGO	Erythrura gouldiae (Gouldian finch)
ENSCAF	Canis lupus dingo (Dingo)
ENSRRO	Rhinopithecus roxellana (Golden snub-nosed monkey)
ENSCMI	Callorhinchus milii (Elephant shark)
ENSPRE	Poecilia reticulata (Guppy)
ENSOGA	Otolemur garnettii (Bushbaby)
MGP_C3HHeJ_	Mus musculus (Mouse C3H/HeJ)
ENSSSC	Sus scrofa (Pig - Bamei)
ENSMFA	Macaca fascicularis (Crab-eating macaque)
ENSLBE	Labrus bergylta (Ballan wrasse)
MGP_CBAJ_	Mus musculus (Mouse CBA/J)
ENSCIN	Ciona intestinalis
ENSCCR	Cyprinus carpio (Common carp huanghe)
ENSOPR	Ochotona princeps (Pika)
ENSLSD	Lonchura striata domestica (Bengalese finch)
ENSCLA	Chinchilla lanigera (Long-tailed chinchilla)
ENSSGR	Sinocyclocheilus grahami (Golden-line barbel)
ENSHGLF	Heterocephalus glaber (Naked mole-rat female)
ENSCPI	Chrysemys picta bellii (Painted turtle)
ENSPEM	Peromyscus maniculatus bairdii (Northern American deer mouse)
ENSSCU	Struthio camelus australis (African ostrich)
ENSTMT	Terrapene carolina triunguis (Three-toed box turtle)
MGP_FVBNJ_	Mus musculus (Mouse FVB/NJ)
ENSPCI	Phascolarctos cinereus (Koala)
ENSMIC	Microcebus murinus (Mouse Lemur)
ENSCHA	Clupea harengus (Atlantic herring)
ENSPLA	Poecilia latipinna (Sailfin molly)
